32
*
32
*
1
*
00-1-0
#
01-1-1
#
02-1-2
#
03-1-3
#
04-1-4
#
05-1-5
#
06-1-6
#
07-1-7
#
08-1-8
#
09-1-9
#
10-1-10
#
11-1-11
#
12-1-12
#
13-1-13
#
14-1-14
#
15-1-15
#
16-1-16
#
17-1-17
#
18-1-18
#
19-1-19
#
20-1-20
#
21-1-21
#
22-1-22
#
23-1-23
#
24-1-24
#
25-1-25
#
26-1-26
#
27-1-27
#
28-1-28
#
29-1-29
#
30-1-30
#
31-1-31
#
32-1-32
#
33-1-33
#
34-1-34
#
35-1-35
#
36-1-36
#
37-1-37
#
38-1-38
#
39-1-39
#
40-1-40
#
41-1-41
#
42-1-42
#
43-1-43
#
44-1-44
#
45-1-45
#
46-1-46
#
47-1-47
#
48-1-48
#
49-1-49
#
50-1-50
#
51-1-51
#
52-1-52
#
53-1-53
#
54-1-54
#
55-1-55
#
56-1-56
#
57-1-57
#
58-1-58
#
59-1-59
#
60-1-60
#
61-1-61
#
62-1-62
#
63-1-63
#
64-1-64
#
65-1-65
#
66-1-66
#
67-1-67
#
68-1-68
#
69-1-69
#
70-1-70
#
71-1-71
#
72-1-72
#
73-1-73
#
74-1-74
#
75-1-75
#
76-1-76
#
77-1-77
#
78-1-78
#
79-1-79
#
80-1-80
#
81-1-81
*
00000000000000000000000000000000
00000000000000000000000000000000
00000000000000000000000000000000
00000000000000000000000000000000
00111111111110001111111111111111
00111111111110001111111101111111
00111100101110001100111111101000
00111100111110001111111111101000
00000000111110001110001001111000
00000000111110001111111100111000
00000000111110001000111111111000
00000000111100001111111111111000
00000000111100000001100000000000
00000000111100001111111111111110
00000000111100001111111001111110
00000000111100001111111001111000
00000111111100011111111110011000
00111111111100011111111000011000
00111111001000000000011001111110
00111111000010000000011111111110
00000111000010000000000000000110
00000011111110011110000000000110
00000011111110011110000000000110
00000001111110011111111111111110
00000001111110000000000110000000
00000000111110000000000110000000
00000000111110000000000110000000
00000000011111111111111111111110
00000000011111111111111111111110
00000001111110000000000000000000
00000011000000000000000000000000
00000011000000000000000000000000
*
17 16 17 16 17 16 17 16 17 16 17 16 17 16 17 16 17 16 17 16 17 16 17 16 17 16 17 16 17 16 17 16
18 19 18 19 18 19 18 19 18 19 18 19 18 19 18 19 18 19 18 19 18 19 18 19 18 19 18 19 18 19 18 19
24 25 24 25 24 25 24 25 24 25 24 25 24 25 24 25 24 25 24 25 24 25 24 25 24 25 24 25 24 25 24 25
57 58 32 33 32 33 32 33 32 33 32 33 32 33 32 33 32 33 32 33 32 33 32 33 32 33 32 33 32 33 32 33
24 25 01 02 02 02 02 02 02 02 02 65 43 16 17 29 01 02 02 02 02 02 02 02 02 02 02 02 02 02 02 02
57 58 69 03 03 08 68 68 03 03 38 67 43 24 25 29 69 03 03 03 03 04 03 03 63 03 03 03 08 68 68 68
24 25 69 03 03 67 16 17 69 55 03 67 43 57 58 29 69 03 63 63 03 03 03 03 03 03 03 63 67 51 51 51
57 58 64 68 68 66 24 25 69 03 03 67 43 24 25 29 69 03 03 03 03 03 03 03 03 03 03 63 67 51 52 16
24 25 16 17 16 17 32 33 69 38 03 67 43 57 58 29 69 04 03 63 63 63 03 63 63 03 03 03 67 51 60 24
57 58 24 25 24 25 10 76 69 03 38 67 43 24 25 29 69 03 03 03 03 03 03 03 63 63 03 04 67 51 52 57
24 25 32 33 32 33 81 79 69 38 03 67 43 57 58 29 69 63 63 63 03 03 04 03 03 03 03 03 67 51 60 24
57 58 41 42 41 42 81 79 64 68 68 66 29 24 25 29 64 68 68 68 68 68 68 68 68 68 68 68 68 51 52 57
24 25 10 11 11 11 09 79 35 00 40 00 29 57 58 29 51 51 51 00 00 51 51 51 51 51 51 51 51 51 60 24 
57 58 81 05 12 75 80 77 23 23 00 00 29 24 25 29 00 00 00 00 00 00 00 00 00 00 00 35 00 36 00 57
24 25 78 74 45 79 53 54 23 00 20 00 29 57 58 29 00 00 36 00 00 00 00 53 54 00 00 00 00 00 00 24
57 58 48 81 75 77 61 62 00 14 23 00 29 24 25 29 00 00 00 00 00 00 00 61 62 00 00 00 00 16 17 57
24 25 56 78 77 35 00 23 00 00 28 00 07 57 58 00 00 00 00 00 37 00 00 00 00 53 54 00 00 24 25 24
57 58 00 21 00 59 23 14 00 30 31 00 07 24 25 00 00 35 00 00 00 00 00 00 00 61 62 00 00 32 33 57
24 25 00 00 00 00 00 00 16 17 35 07 07 57 58 16 17 16 17 16 17 00 00 53 54 00 00 37 00 00 00 24
57 58 37 00 00 28 00 22 24 25 07 07 00 24 25 24 25 24 25 24 25 20 00 61 62 00 00 00 00 00 00 57
24 25 37 37 00 00 00 00 32 33 49 50 00 57 58 32 33 32 33 57 58 16 17 16 17 16 17 16 17 00 00 24
57 58 10 11 76 00 00 00 00 00 00 00 00 24 25 00 00 30 31 24 25 24 25 24 25 24 25 24 25 00 00 57
24 25 81 44 73 76 22 00 28 00 00 35 00 57 58 00 00 00 00 32 33 32 33 32 33 32 33 32 33 00 28 24
57 58 81 12 12 79 00 00 00 00 00 00 00 24 25 34 34 00 00 00 00 00 00 00 23 00 00 00 00 00 00 57
24 25 81 12 06 73 76 42 00 00 36 00 00 57 58 16 17 16 17 16 17 16 17 00 00 16 17 16 17 16 17 24
57 58 81 12 12 12 73 76 00 00 00 00 00 24 25 24 25 24 25 24 25 24 25 00 00 24 25 24 25 24 25 57
24 25 81 45 12 12 12 79 34 00 00 00 00 32 33 32 33 32 33 32 33 32 33 00 00 32 33 32 33 32 33 24
57 58 81 12 12 12 06 73 76 00 00 37 00 00 00 00 00 00 00 00 00 28 00 00 00 00 00 00 00 00 28 57
24 25 81 12 05 12 75 80 77 00 00 00 00 28 00 00 00 20 00 00 00 00 00 00 23 00 00 00 00 00 00 25
57 58 81 12 12 75 77 00 00 28 00 00 00 16 17 16 17 16 17 16 17 16 17 16 17 16 17 16 17 16 17 57
24 25 81 12 12 79 36 00 52 52 52 52 52 24 25 24 25 24 25 24 25 24 25 24 25 24 25 24 25 24 25 25
32 33 81 47 46 79 36 00 60 60 60 60 60 32 33 32 33 32 33 32 33 32 33 32 33 32 33 32 33 32 33 32

